+-----------------------------------------+
| |-------------------------------------| |
| || 3   0   9 | 0   6   0 | 0   0   8 || |
| ||-----------|-----------|-----------|| |
| || 0   7   0 | 2   3   0 | 0   0   1 || |
| ||-----------|-----------|-----------|| |
| || 0   6   0 | 0   0   8 | 0   0   0 || |
| |-------------------------------------| |
| || 0   0   5 | 4   0   0 | 1   8   0 || |
| ||-----------|-----------|-----------|| |
| || 8   0   0 | 6   0   0 | 0   0   5 || |
| ||-----------|-----------|-----------|| |
| || 0   9   1 | 0   0   5 | 3   0   0 || |
| |-------------------------------------| |
| || 0   0   0 | 3   0   0 | 0   1   0 || |
| ||-----------|-----------|-----------|| |
| || 9   0   0 | 0   8   6 | 0   5   0 || |
| ||-----------|-----------|-----------|| |
| || 7   0   0 | 0   1   0 | 6   0   3 || |
| |-------------------------------------| |
+-----------------------------------------+