+-----------------------------------------+
| |-------------------------------------| |
| || 3   4   9 | 1   6   7 | 5   2   8 || |
| ||-----------|-----------|-----------|| |
| || 5   7   0 | 2   3   4 | 9   6   1 || |
| ||-----------|-----------|-----------|| |
| || 1   6   2 | 9   5   8 | 7   3   4 || |
| |-------------------------------------| |
| || 6   2   5 | 4   7   3 | 1   8   9 || |
| ||-----------|-----------|-----------|| |
| || 8   3   7 | 6   9   1 | 2   4   5 || |
| ||-----------|-----------|-----------|| |
| || 4   9   1 | 8   2   5 | 3   7   6 || |
| |-------------------------------------| |
| || 2   5   6 | 3   4   9 | 8   1   7 || |
| ||-----------|-----------|-----------|| |
| || 9   1   3 | 7   8   6 | 4   5   2 || |
| ||-----------|-----------|-----------|| |
| || 7   8   4 | 5   1   2 | 6   9   3 || |
| |-------------------------------------| |
+-----------------------------------------+