+-----------------------------------------+
| |-------------------------------------| |
| || 7   1   4 | 3   5   6 | 8   2   9 || |
| ||-----------|-----------|-----------|| |
| || 5   8   2 | 4   1   9 | 6   7   3 || |
| ||-----------|-----------|-----------|| |
| || 6   9   3 | 7   2   8 | 4   5   1 || |
| |-------------------------------------| |
| || 3   7   9 | 8   6   4 | 5   1   2 || |
| ||-----------|-----------|-----------|| |
| || 2   5   6 | 1   9   3 | 7   8   4 || |
| ||-----------|-----------|-----------|| |
| || 1   4   8 | 2   7   5 | 9   3   6 || |
| |-------------------------------------| |
| || 4   2   5 | 6   3   7 | 1   9   8 || |
| ||-----------|-----------|-----------|| |
| || 8   3   7 | 9   4   1 | 2   6   5 || |
| ||-----------|-----------|-----------|| |
| || 9   6   1 | 5   8   2 | 3   4   7 || |
| |-------------------------------------| |
+-----------------------------------------+