+-----------------------------------------+
| |-------------------------------------| |
| || 7   4   8 | 2   3   5 | 9   1   6 || |
| ||-----------|-----------|-----------|| |
| || 6   1   2 | 7   4   9 | 5   8   3 || |
| ||-----------|-----------|-----------|| |
| || 9   5   3 | 6   1   8 | 7   2   4 || |
| |-------------------------------------| |
| || 3   6   4 | 5   2   1 | 8   9   7 || |
| ||-----------|-----------|-----------|| |
| || 8   7   1 | 4   9   3 | 2   6   5 || |
| ||-----------|-----------|-----------|| |
| || 2   9   5 | 8   6   7 | 3   4   1 || |
| |-------------------------------------| |
| || 1   8   9 | 3   5   6 | 4   7   2 || |
| ||-----------|-----------|-----------|| |
| || 4   3   7 | 1   8   2 | 6   5   9 || |
| ||-----------|-----------|-----------|| |
| || 5   2   6 | 9   7   4 | 1   3   8 || |
| |-------------------------------------| |
+-----------------------------------------+